66
14
22 4 0 0 0 0 0 0 0 0 0 0 0 0 0 0 0 0 0 0 0 0 0 0 0 0 0 0 0 0 0 0 0 0 0 0 0 0 0 0 0 0 0 0 0 0 0 0 0 0 0 0 0 0 0 0 0 0 0 0 0 0 0 0 0 0 0 0 0 0 0 0 0 0 0 0 0 0 0 0 0   
22 4 0 0 0 0 0 0 0 0 0 0 0 0 0 0 0 0 0 0 0 0 0 0 0 0 0 0 0 0 0 0 0 0 0 0 0 0 0 0 0 0 0 0 0 0 0 0 0 0 0 0 0 0 0 0 0 0 0 0 0 0 0 0 0 0 0 0 0 0 0 0 0 0 0 0 0 0 0 0 0 0 
22 4 0 0 0 0 0 0 0 0 0 0 0 0 0 0 0 0 0 0 23 24 25 0 0 0 0 0 0 0 0 0 0 0 0 0 3 21 21 21 4 0 0 0 0 0 0 0 0 0 0 0 0 0 0 0 0 0 0 0 0 23 24 25 0 0 0 0 0 3 21 21 21 4 0 0 0 0 0 0 0 0 
22 4 23 24 25 0 0 0 0 0 0 0 0 0 0 0 0 0 0 0 0 0 0 0 0 0 0 0 0 0 0 0 0 0 0 0 0 0 0 0 0 0 0 0 0 0 0 0 0 0 0 0 0 0 0 0 0 0 0 0 0 0 0 0 0 0 0 0 0 0 0 0 0 0 0 0 0 0 0 0 
22 4 0 0 0 0 0 0 0 0 3 21 4 0 0 23 24 25 0 0 0 0 0 23 24 25 0 0 0 0 0 0 0 0 0 0 0 0 0 0 0 0 0 0 0 3 21 21 21 4 0 0 0 0 0 0 0 0 0 0 0 3 21 21 21 4 0 0 0 0 0 0 0 0 0 0 0 0 0 0 0 0 
22 4 0 3 21 21 21 21 21 21 21 4 0 0 0 0 0 0 0 0 0 0 0 0 0 0 0 0 0 0 0 0 0 0 0 0 0 0 0 23 24 24 25 0 0 0 0 0 0 0 0 0 0 0 0 0 0 0 0 0 0 0 0 0 0 0 0 0 0 0 0 0 0 0 0 0 0 0 0 0 0 0 
22 4 0 0 0 0 0 0 0 0 0 0 0 0 0 0 0 0 0 0 0 0 23 24 25 0 0 0 0 0 0 23 24 25 0 0 0 0 0 0 0 0 0 0 0 0 0 0 0 0 3 21 21 21 4 0 0 0 0 0 0 0 0 0 3 21 21 21 4 0 0 0 0 0 0 0 0 0 0 0 0 0 
22 4 0 0 0 0 0 0 0 3 21 21 21 4 0 0 0 0 0 0 0 0 0 0 0 0 0 0 0 0 0 0 0 0 0 0 0 0 0 0 0 0 0 0 0 0 0 0 0 0 0 0 0 0 0 0 0 0 0 0 0 0 0 0 0 0 0 0 0 0 0 0 0 0 0 0 0 0 0 0 0 0   
22 4 0 0 0 0 0 0 0 0 0 0 0 0 0 0 0 0 0 0 0 0 0 0 0 0 0 23 24 25 0 0 0 0 0 0 0 0 0 0 10 0 0 0 0 0 0 0 0 0 0 0 0 0 0 0 0 0 0 3 21 21 21 4 0 0 0 0 0 0 0 0 0 0 0 0 0 0 0 0 0 0 0 0 0 0  
22 4 0 0 0 0 3 21 21 21 4 0 0 0 0 0 0 0 0 0 0 0 0 0 0 0 0 0 0 0 0 0 0 0 0 0 0 0 0 23 24 25 0 0 0 0 0 0 0 0 0 0 0 0 0 0 0 0 0 0 0 0 0 0 0 0 0 0 0 0 0 0 0 0 0 0 3 21 21 21 4 0 0 0 0 0 0  
22 4 0 0 0 0 0 0 0 0 0 0 0 0 0 0 0 0 0 0 0 0 0 23 24 25 0 0 0 0 0 0 0 0 23 25 0 0 0 0 0 0 0 0 0 0 9 11 0 0 0 0 0 0 0 0 0 0 0 0 0 0 0 0 0 0 0 0 0 0 0 0 0 0 0 0 0 0 0 0 0 0 0 0 0 0 0 0 0 0 0 
22 4 0 0 0 0 0 0 0 0 0 0 0 0 0 0 0 0 0 0 0 0 10 9 0 0 0 0 0 0 10 0 0 0 0 0 0 11 0 0 0 0 0 1 21 21 21 21 2 0 0 0 9 0 0 0 0 9 0 0 0 3 21 21 21 4 0 0 0 0 0 0 0 0 0 0 0 0 0 0 0 0 0 0 3  
22 4 0 0 10 3 21 21 4 11 3 21 21 21 21 21 4 0 0 0 0 1 21 21 21 2 0 0 9 1 21 21 2 0 9 1 21 21 2 0 0 0 0 3 22 22 22 22 4 10 0 1 21 2 0 0 1 21 2 11 1 21 6 22 22 4 0 0 0 0 0 0 0 9 0 0 10 9 0  
5 21 21 21 21 21 21 21 21 21 21 6 22 22 22 22 4 0 0 0 3 22 22 22 22 21 21 21 21 21 6 5 21 21 21 21 6 22 4 0 0 0 0 3 22 22 22 5 21 21 21 21 21 21 21 21 21 21 21 21 21 6 22 22 22 4 0 0 0 0  
